//MAP CONVERTED BY dmm2tgm.py THIS HEADER COMMENT PREVENTS RECONVERSION, DO NOT REMOVE
"ab" = (
/obj/effect/spawner/structure/window/reinforced,
/turf/open/floor/plating,
/area/ruin/unpowered/colony/atmos)
"bd" = (
/obj/effect/turf_decal/tile/blue{
	dir = 4
	},
/obj/structure/closet/wardrobe/grey,
/turf/open/floor/iron/white/corner,
/area/ruin/unpowered/colony/hallways)
"br" = (
/obj/effect/turf_decal/stripes/white/line{
	dir = 1
	},
/obj/structure/chair/sofa/bench/left{
	dir = 1
	},
/obj/structure/railing/corner{
	dir = 8
	},
/turf/open/floor/planetary/concrete,
/area/ruin/unpowered/colony/outdoors/cargo_bay)
"bQ" = (
/obj/machinery/door/airlock,
/turf/open/floor/iron,
/area/ruin/unpowered/colony/dorms)
"cl" = (
/turf/open/floor/iron,
/area/ruin/unpowered/colony/mess_hall)
"cC" = (
/obj/effect/turf_decal/stripes/white/line{
	dir = 1
	},
/obj/structure/railing/corner,
/turf/open/floor/planetary/concrete,
/area/ruin/unpowered/colony/outdoors/cargo_bay)
"cE" = (
/obj/machinery/door/airlock,
/turf/open/floor/iron,
/area/ruin/unpowered/colony/bathroom)
"cF" = (
/obj/effect/turf_decal/stripes/white/line,
/turf/open/floor/planetary/concrete,
/area/ruin/unpowered/colony/outdoors/cargo_bay)
"cQ" = (
/obj/item/kitchen/knife/shiv,
/turf/open/floor/planetary/concrete,
/area/ruin/unpowered/colony/outdoors/cargo_bay)
"de" = (
/obj/machinery/door/airlock/command,
/turf/open/floor/iron,
/area/ruin/unpowered/colony/ops)
"dt" = (
/obj/machinery/door/airlock,
/turf/open/floor/iron,
/area/ruin/unpowered/colony/mess_hall)
"dv" = (
/obj/effect/spawner/structure/window/reinforced,
/turf/open/floor/plating,
/area/ruin/unpowered/colony/external_airlock)
"dJ" = (
/obj/effect/spawner/structure/window/plasma/reinforced,
/turf/open/floor/plating,
/area/ruin/unpowered/colony/operating_theatre)
"dP" = (
/obj/structure/table,
/turf/open/floor/iron/dark{
	initial_gas_mix = "PLANETARY_ATMOS"
	},
/area/ruin/unpowered/colony/hallways)
"dX" = (
/turf/open/floor/iron,
/area/ruin/unpowered/colony/secure_storage)
"eo" = (
/obj/effect/spawner/structure/window/plasma/reinforced,
/turf/open/floor/plating,
/area/ruin/unpowered/colony/medbay)
"et" = (
/obj/effect/turf_decal/tile/blue{
	dir = 8
	},
/turf/open/floor/iron/white/corner,
/area/ruin/unpowered/colony/hallways)
"gb" = (
/turf/closed/wall,
/area/ruin/unpowered/colony/bathroom)
"gp" = (
/obj/machinery/door/airlock/vault,
/turf/open/floor/iron,
/area/ruin/unpowered/colony/secure_storage)
"gB" = (
/obj/effect/turf_decal/tile/red,
/turf/open/floor/iron,
/area/ruin/unpowered/colony/hallways)
"ho" = (
/obj/structure/grille,
/obj/effect/spawner/clear,
/turf/template_noop,
/area/template_noop)
"hE" = (
/obj/effect/spawner/structure/window/plasma/reinforced,
/turf/open/floor/plating,
/area/ruin/unpowered/colony/security)
"ie" = (
/obj/effect/turf_decal/stripes/white/box,
/obj/structure/closet/crate/build_your_shuttle_extra,
/turf/open/floor/planetary/concrete,
/area/ruin/unpowered/colony/outdoors/cargo_bay)
"iw" = (
/turf/open/floor/iron,
/area/ruin/unpowered/colony/operating_theatre)
"ix" = (
/turf/closed/wall/r_wall,
/area/ruin/unpowered/colony/external_airlock)
"iI" = (
/obj/machinery/door/airlock/external,
/obj/effect/mapping_helpers/airlock/cyclelink_helper{
	dir = 8
	},
/turf/open/floor/plating,
/area/ruin/unpowered/colony/external_airlock)
"iR" = (
/obj/effect/spawner/structure/window/reinforced,
/turf/open/floor/plating,
/area/ruin/unpowered/colony/medbay)
"jd" = (
/turf/closed/wall/r_wall,
/area/ruin/unpowered/colony/mess_hall)
"jx" = (
/obj/effect/turf_decal/stripes/white/line{
	dir = 8
	},
/obj/effect/decal/cleanable/blood/old,
/obj/effect/decal/remains/human,
/turf/open/floor/planetary/concrete,
/area/ruin/unpowered/colony/outdoors/cargo_bay)
"jI" = (
/obj/effect/turf_decal/stripes/white/line{
	dir = 1
	},
/obj/structure/chair/sofa/bench/right{
	dir = 1
	},
/turf/open/floor/planetary/concrete,
/area/ruin/unpowered/colony/outdoors/cargo_bay)
"kv" = (
/turf/closed/wall/r_wall,
/area/ruin/unpowered/colony/medbay)
"kA" = (
/obj/effect/turf_decal/stripes/white/line,
/obj/structure/chair/sofa/bench/left,
/turf/open/floor/planetary/concrete,
/area/ruin/unpowered/colony/outdoors/cargo_bay)
"kH" = (
/obj/effect/spawner/structure/window/plasma/reinforced,
/turf/open/floor/plating,
/area/ruin/unpowered/colony/ops)
"md" = (
/obj/structure/railing{
	dir = 8
	},
/turf/open/floor/planetary/concrete,
/area/ruin/unpowered/colony/outdoors/cargo_bay)
"me" = (
/turf/open/floor/iron/corner{
	dir = 1
	},
/area/ruin/unpowered/colony/hallways)
"mg" = (
/obj/effect/spawner/structure/window/plasma/reinforced/grille,
/turf/open/floor/plating,
/area/ruin/unpowered/colony/hallways)
"mo" = (
/turf/open/floor/engine/n2,
/area/ruin/unpowered/colony/atmos)
"mX" = (
/obj/effect/turf_decal/tile/blue{
	dir = 8
	},
/obj/machinery/vending/snack,
/turf/open/floor/iron/white/corner,
/area/ruin/unpowered/colony/hallways)
"mY" = (
/obj/machinery/suit_storage_unit/open,
/turf/open/floor/plating,
/area/ruin/unpowered/colony/external_airlock)
"ne" = (
/obj/structure/railing{
	dir = 8
	},
/turf/open/floor/planetary/concrete,
/area/template_noop)
"oD" = (
/obj/structure/railing,
/obj/effect/turf_decal/stripes/white/line{
	dir = 1
	},
/turf/open/floor/planetary/concrete,
/area/ruin/unpowered/colony/outdoors/cargo_bay)
"oJ" = (
/turf/open/floor/iron,
/area/ruin/unpowered/colony/security)
"pf" = (
/obj/structure/chair/office{
	dir = 4
	},
/turf/open/floor/iron/dark{
	initial_gas_mix = "PLANETARY_ATMOS"
	},
/area/ruin/unpowered/colony/hallways)
"pY" = (
/obj/structure/holohoop{
	dir = 4
	},
/obj/effect/turf_decal/bot_white,
/turf/open/floor/planetary/concrete,
/area/ruin/unpowered/colony/outdoors/cargo_bay)
"qk" = (
/obj/machinery/door/airlock/engineering,
/turf/open/floor/iron,
/area/ruin/unpowered/colony/engineering)
"qw" = (
/turf/closed/wall/r_wall,
/area/ruin/unpowered/colony/secure_storage)
"re" = (
/obj/effect/spawner/structure/window,
/turf/open/floor/plating,
/area/ruin/unpowered/colony/hallways)
"rN" = (
/turf/closed/wall,
/area/ruin/unpowered/colony/medbay)
"tB" = (
/obj/effect/turf_decal/tile/red{
	dir = 1
	},
/turf/open/floor/iron/dark{
	initial_gas_mix = "PLANETARY_ATMOS"
	},
/area/ruin/unpowered/colony/hallways)
"tQ" = (
/obj/structure/closet/crate/silvercrate,
/turf/open/floor/planetary/concrete,
/area/ruin/unpowered/colony/outdoors/cargo_bay)
"uw" = (
/turf/open/floor/iron,
/area/ruin/unpowered/colony/medbay)
"uF" = (
/turf/closed/wall,
/area/ruin/unpowered/colony/armory)
"uG" = (
/obj/effect/turf_decal/tile/blue{
	dir = 4
	},
/obj/structure/closet/wardrobe/green,
/turf/open/floor/iron/white/corner,
/area/ruin/unpowered/colony/hallways)
"uW" = (
/obj/effect/turf_decal/stripes/white/line,
/obj/structure/chair/sofa/bench/right,
/turf/open/floor/planetary/concrete,
/area/ruin/unpowered/colony/outdoors/cargo_bay)
"vP" = (
/turf/open/floor/iron,
/area/ruin/unpowered/colony/engineering)
"ws" = (
/obj/effect/spawner/structure/window/reinforced,
/turf/open/floor/plating,
/area/ruin/unpowered/colony/engineering)
"wE" = (
/turf/open/floor/engine/o2,
/area/ruin/unpowered/colony/atmos)
"wM" = (
/obj/effect/spawner/structure/window/reinforced,
/turf/open/floor/plating,
/area/ruin/unpowered/colony/hallways)
"wQ" = (
/obj/structure/rack,
/turf/open/floor/plating,
/area/ruin/unpowered/colony/external_airlock)
"xf" = (
/obj/machinery/door/airlock/atmos,
/turf/open/floor/iron,
/area/ruin/unpowered/colony/atmos)
"xg" = (
/obj/machinery/door/airlock/medical,
/turf/open/floor/iron,
/area/ruin/unpowered/colony/operating_theatre)
"xk" = (
/turf/closed/wall,
/area/ruin/unpowered/colony/dorms)
"xG" = (
/turf/open/floor/iron,
/area/ruin/unpowered/colony/armory)
"yC" = (
/turf/closed/wall,
/area/ruin/unpowered/colony/mess_hall)
"yG" = (
/turf/open/floor/iron,
/area/ruin/unpowered/colony/dorms)
"yJ" = (
/turf/closed/wall,
/area/ruin/unpowered/colony/external_airlock)
"yZ" = (
/turf/closed/wall,
/area/ruin/unpowered/colony/security)
"zc" = (
/turf/closed/wall/r_wall,
/area/ruin/unpowered/colony/dorms)
"zf" = (
/obj/structure/railing,
/obj/effect/turf_decal/stripes/white/corner{
	dir = 1
	},
/turf/open/floor/planetary/concrete,
/area/ruin/unpowered/colony/outdoors/cargo_bay)
"zp" = (
/turf/closed/wall,
/area/ruin/unpowered/colony/hallways)
"zt" = (
/obj/structure/rack/shelf,
/turf/open/floor/plating,
/area/ruin/unpowered/colony/external_airlock)
"zT" = (
/obj/structure/table,
/obj/effect/turf_decal/tile/red,
/turf/open/floor/iron/dark{
	initial_gas_mix = "PLANETARY_ATMOS"
	},
/area/ruin/unpowered/colony/hallways)
"zW" = (
/obj/effect/spawner/structure/window/reinforced,
/turf/open/floor/plating,
/area/ruin/unpowered/colony/security)
"AA" = (
/turf/open/floor/engine/airless,
/area/ruin/unpowered/colony/atmos)
"BT" = (
/turf/open/floor/planetary/concrete,
/area/template_noop)
"BY" = (
/turf/open/floor/iron,
/area/ruin/unpowered/colony/ops)
"Cf" = (
/obj/structure/railing,
/turf/open/floor/planetary/concrete/reinforced,
/area/ruin/unpowered/colony/outdoors/cargo_bay)
"CB" = (
/obj/effect/turf_decal/stripes/white/box,
/turf/open/floor/planetary/concrete,
/area/ruin/unpowered/colony/outdoors/cargo_bay)
"Do" = (
/obj/effect/spawner/structure/window/reinforced,
/turf/open/floor/plating,
/area/ruin/unpowered/colony/mess_hall)
"Dx" = (
/obj/effect/spawner/structure/window/plasma/reinforced,
/turf/open/floor/plating,
/area/ruin/unpowered/colony/hallways)
"Eb" = (
/turf/closed/wall,
/area/ruin/unpowered/colony/engineering)
"Er" = (
/turf/open/floor/iron,
/area/ruin/unpowered/colony/hallways)
"Ew" = (
/obj/effect/turf_decal/loading_area/white{
	dir = 8
	},
/turf/open/floor/planetary/concrete,
/area/ruin/unpowered/colony/outdoors/cargo_bay)
"EG" = (
/obj/structure/closet/crate/solarpanel_small,
/turf/open/floor/planetary/concrete,
/area/ruin/unpowered/colony/outdoors/cargo_bay)
"EP" = (
/turf/closed/wall/r_wall,
/area/ruin/unpowered/colony/armory)
"EY" = (
/turf/open/floor/iron,
/area/ruin/unpowered/colony/bathroom)
"Fc" = (
/obj/effect/spawner/structure/window/plasma/reinforced,
/turf/open/floor/plating,
/area/ruin/unpowered/colony/atmos)
"Ff" = (
/turf/open/floor/iron,
/area/ruin/unpowered/colony/atmos)
"Fp" = (
/obj/structure/holohoop{
	dir = 8
	},
/obj/effect/turf_decal/bot_white,
/turf/open/floor/planetary/concrete,
/area/ruin/unpowered/colony/outdoors/cargo_bay)
"Fr" = (
/obj/structure/low_wall,
/obj/structure/grille/broken,
/turf/open/floor/plating{
	initial_gas_mix = "PLANETARY_ATMOS"
	},
/area/ruin/unpowered/colony/hallways)
"FF" = (
/turf/closed/wall/r_wall,
/area/ruin/unpowered/colony/hallways)
"FK" = (
/turf/closed/wall/r_wall,
/area/ruin/unpowered/colony/ops)
"Gb" = (
/obj/effect/turf_decal/loading_area/white{
	dir = 4
	},
/turf/open/floor/planetary/concrete,
/area/ruin/unpowered/colony/outdoors/cargo_bay)
"Gc" = (
/obj/machinery/door/airlock/security,
/turf/open/floor/iron,
/area/ruin/unpowered/colony/armory)
"Gu" = (
/obj/machinery/door/airlock/external,
/obj/effect/mapping_helpers/airlock/cyclelink_helper{
	dir = 4
	},
/turf/open/floor/plating,
/area/ruin/unpowered/colony/external_airlock)
"GL" = (
/obj/effect/turf_decal/tile/blue{
	dir = 4
	},
/obj/structure/closet/wardrobe/black,
/turf/open/floor/iron/white/corner,
/area/ruin/unpowered/colony/hallways)
"GV" = (
/turf/open/floor/planetary/concrete/reinforced,
/area/ruin/unpowered/colony/outdoors/cargo_bay)
"Hy" = (
/obj/effect/turf_decal/stripes/white/line{
	dir = 8
	},
/turf/open/floor/planetary/concrete,
/area/ruin/unpowered/colony/outdoors/cargo_bay)
"It" = (
/obj/effect/spawner/structure/window/plasma/reinforced,
/turf/open/floor/plating,
/area/ruin/unpowered/colony/mess_hall)
"Jf" = (
/obj/machinery/door/airlock/security,
/turf/open/floor/iron,
/area/ruin/unpowered/colony/security)
"Jg" = (
/turf/open/floor/iron/large,
/area/ruin/unpowered/colony/hallways)
"Jv" = (
/turf/template_noop,
/area/template_noop)
"JF" = (
/turf/closed/wall/r_wall,
/area/ruin/unpowered/colony/operating_theatre)
"Kq" = (
/obj/effect/turf_decal/stripes/white/line{
	dir = 4
	},
/turf/open/floor/planetary/concrete,
/area/ruin/unpowered/colony/outdoors/cargo_bay)
"Kx" = (
/obj/machinery/door/airlock,
/turf/open/floor/iron,
/area/ruin/unpowered/colony/hallways)
"Ly" = (
/turf/closed/wall,
/area/ruin/unpowered/colony/atmos)
"Lz" = (
/obj/item/toy/beach_ball/holoball,
/obj/effect/turf_decal/stripes/white/line{
	dir = 4
	},
/turf/open/floor/planetary/concrete,
/area/ruin/unpowered/colony/outdoors/cargo_bay)
"LD" = (
/turf/closed/wall/r_wall,
/area/ruin/unpowered/colony/atmos)
"Nk" = (
/obj/structure/frame/computer{
	dir = 1
	},
/obj/effect/turf_decal/tile/red{
	dir = 8
	},
/turf/open/floor/iron/dark{
	initial_gas_mix = "PLANETARY_ATMOS"
	},
/area/ruin/unpowered/colony/hallways)
"Nm" = (
/obj/structure/grille,
/turf/open/floor/planetary/concrete,
/area/ruin/unpowered/colony/outdoors/cargo_bay)
"NA" = (
/turf/closed/wall/r_wall,
/area/template_noop)
"NC" = (
/obj/machinery/door/airlock/security,
/obj/effect/mapping_helpers/airlock/access/all/security/general,
/turf/open/floor/iron/dark/side,
/area/ruin/unpowered/colony/hallways)
"Os" = (
/obj/structure/table_frame,
/obj/effect/turf_decal/tile/red{
	dir = 4
	},
/turf/open/floor/iron/dark{
	initial_gas_mix = "PLANETARY_ATMOS"
	},
/area/ruin/unpowered/colony/hallways)
"OQ" = (
/obj/structure/railing{
	dir = 1
	},
/turf/open/floor/planetary/concrete,
/area/template_noop)
"Pi" = (
/obj/effect/spawner/structure/window/plasma/reinforced,
/turf/open/floor/plating,
/area/ruin/unpowered/colony/engineering)
"PB" = (
/turf/closed/wall,
/area/ruin/unpowered/colony/ops)
"PT" = (
/obj/machinery/door/airlock/silver,
/turf/open/floor/iron,
/area/ruin/unpowered/colony/ops)
"Qv" = (
/obj/structure/grille,
/turf/open/floor/planetary/concrete,
/area/template_noop)
"RS" = (
/turf/closed/wall,
/area/ruin/unpowered/colony/operating_theatre)
"SJ" = (
/turf/open/floor/planetary/concrete,
/area/ruin/unpowered/colony/outdoors/cargo_bay)
"Tt" = (
/turf/open/floor/planetary/concrete,
/area/ruin/unpowered/colony/ops)
"Tv" = (
/turf/open/floor/plating,
/area/ruin/unpowered/colony/external_airlock)
"Ug" = (
/obj/machinery/door/airlock/medical,
/turf/open/floor/iron,
/area/ruin/unpowered/colony/medbay)
"Uy" = (
/obj/effect/turf_decal/tile/blue{
	dir = 8
	},
/obj/effect/turf_decal/tile/blue{
	dir = 4
	},
/obj/structure/closet/wardrobe/mixed,
/turf/open/floor/iron/white/corner,
/area/ruin/unpowered/colony/hallways)
"UM" = (
/obj/effect/turf_decal/tile/blue{
	dir = 8
	},
/obj/machinery/vending/coffee,
/turf/open/floor/iron/white/corner,
/area/ruin/unpowered/colony/hallways)
"VE" = (
/turf/open/floor/iron/corner,
/area/ruin/unpowered/colony/hallways)
"VL" = (
/turf/closed/wall/r_wall,
/area/ruin/unpowered/colony/security)
"Wg" = (
/obj/structure/railing{
	dir = 4
	},
/obj/structure/barricade/security,
/turf/open/floor/planetary/concrete,
/area/ruin/unpowered/colony/outdoors/cargo_bay)
"Yx" = (
/obj/machinery/power/tracker,
/turf/open/floor/planetary/concrete,
/area/template_noop)
"YZ" = (
/turf/closed/wall/r_wall,
/area/ruin/unpowered/colony/engineering)
"Zf" = (
/obj/machinery/power/solar,
/turf/open/floor/planetary/concrete,
/area/template_noop)
"Zm" = (
/obj/effect/turf_decal/tile/red{
	dir = 8
	},
/turf/open/floor/iron,
/area/ruin/unpowered/colony/hallways)
"ZT" = (
/obj/effect/turf_decal/stripes/white/line,
/obj/effect/spawner/lootdrop/crate_spawner,
/turf/open/floor/planetary/concrete,
/area/ruin/unpowered/colony/outdoors/cargo_bay)

(1,1,1) = {"
Jv
Jv
Jv
Jv
Jv
Jv
Jv
Jv
Jv
Jv
Jv
Jv
Jv
Jv
LD
Fc
Fc
Fc
Fc
LD
ne
EP
EP
EP
EP
EP
EP
EP
EP
EP
EP
ne
ne
ne
ne
ne
NA
NA
Jv
"}
(2,1,1) = {"
Jv
Jv
Jv
Jv
Jv
Jv
Jv
Jv
Jv
LD
LD
LD
LD
LD
LD
Ff
Ff
Ff
Ff
LD
Fc
EP
xG
xG
xG
xG
xG
uF
xG
xG
VL
VL
hE
hE
hE
VL
VL
VL
Jv
"}
(3,1,1) = {"
Jv
Jv
Jv
Jv
Jv
Jv
Jv
Jv
Jv
LD
mo
mo
Fc
Ff
Ff
Ff
Ff
Ff
Ff
Ff
Ff
EP
xG
xG
xG
xG
xG
Gc
xG
xG
VL
oJ
oJ
oJ
oJ
oJ
oJ
VL
Jv
"}
(4,1,1) = {"
Jv
Qv
Qv
Qv
Qv
Qv
Qv
Qv
Qv
LD
mo
mo
Fc
Ff
Ff
Ff
Ff
Ff
Ff
Ff
Ff
EP
EP
Gc
EP
EP
EP
EP
EP
EP
VL
oJ
oJ
oJ
oJ
oJ
oJ
VL
Jv
"}
(5,1,1) = {"
Jv
Qv
BT
Zf
Zf
Yx
Zf
Zf
BT
LD
mo
mo
Fc
Ff
Ff
Ff
Ff
Ff
Ff
Ff
Ff
yZ
oJ
oJ
oJ
oJ
oJ
oJ
oJ
oJ
oJ
oJ
oJ
oJ
oJ
oJ
oJ
VL
Jv
"}
(6,1,1) = {"
Jv
Qv
BT
BT
BT
BT
BT
BT
BT
LD
LD
LD
LD
Ff
Ff
Ff
Ff
Ff
Ff
Ff
Ff
yZ
oJ
oJ
oJ
oJ
oJ
oJ
oJ
oJ
oJ
oJ
oJ
oJ
oJ
oJ
oJ
VL
Jv
"}
(7,1,1) = {"
Jv
Qv
BT
Zf
Zf
Zf
Zf
Zf
BT
LD
wE
wE
Fc
Ff
Ff
Ff
Ff
Ff
Ff
Ff
Ff
yZ
yZ
Jf
yZ
yZ
yZ
yZ
yZ
VL
VL
VL
hE
hE
hE
VL
VL
VL
Jv
"}
(8,1,1) = {"
Jv
Qv
BT
BT
BT
BT
BT
BT
BT
LD
wE
wE
Fc
Ff
Ff
Ff
Ff
Ff
Ff
Ff
Ff
yZ
oJ
oJ
oJ
yZ
Er
Er
Er
FF
FF
SJ
SJ
pY
SJ
SJ
VL
VL
Jv
"}
(9,1,1) = {"
Jv
Qv
BT
Zf
Zf
Zf
Zf
Zf
BT
LD
LD
LD
LD
Ff
Ff
Ff
Ff
Ff
Ff
Ff
Ff
yZ
oJ
oJ
oJ
yZ
Er
Er
Er
FF
uW
SJ
SJ
Ew
SJ
SJ
oD
Nm
BT
"}
(10,1,1) = {"
Jv
Qv
BT
BT
BT
BT
BT
BT
BT
LD
AA
AA
Fc
Ff
Ff
Ff
Ff
Ff
Ff
Ff
Ff
yZ
oJ
oJ
oJ
yZ
Er
Er
Er
FF
kA
SJ
tQ
SJ
SJ
SJ
oD
Nm
BT
"}
(11,1,1) = {"
Jv
Qv
BT
Zf
Zf
Zf
Zf
Zf
BT
LD
AA
AA
Fc
Ff
Ff
Ff
Ff
Ff
Ff
Ff
Ff
yZ
oJ
oJ
oJ
yZ
zp
Er
zp
FF
ZT
Kq
Kq
Kq
Lz
Kq
oD
Nm
BT
"}
(12,1,1) = {"
Jv
Qv
BT
BT
BT
BT
BT
BT
BT
LD
LD
LD
LD
Ff
Ff
Ff
Ff
Ff
Ff
Ff
Ff
yZ
oJ
oJ
oJ
Jf
Er
Er
Er
FF
cF
SJ
CB
SJ
CB
SJ
oD
Nm
BT
"}
(13,1,1) = {"
Jv
Qv
BT
Zf
Zf
Zf
Zf
BT
BT
OQ
BT
BT
Fc
Ff
Ff
Ff
Ff
Ff
Ff
Ff
Ff
yZ
oJ
oJ
oJ
yZ
Er
Er
Er
FF
cF
CB
SJ
ie
SJ
CB
br
md
BT
"}
(14,1,1) = {"
Jv
Qv
BT
BT
BT
BT
BT
BT
YZ
YZ
YZ
YZ
YZ
Eb
Eb
Eb
Eb
Eb
xf
ab
Ly
yZ
oJ
oJ
oJ
yZ
Er
Er
Er
FF
cF
Hy
Hy
Hy
Hy
jx
jI
SJ
BT
"}
(15,1,1) = {"
Jv
Qv
BT
Zf
Zf
Zf
Zf
BT
YZ
vP
vP
vP
vP
vP
vP
vP
vP
Eb
Er
Er
Er
yZ
zW
yZ
zW
yZ
Er
Er
Er
FF
cF
EG
SJ
SJ
cQ
SJ
cC
Wg
BT
"}
(16,1,1) = {"
Jv
Qv
BT
BT
BT
BT
BT
BT
Pi
vP
vP
vP
vP
vP
vP
vP
vP
Eb
Er
Er
Er
Er
Er
Er
Er
Er
Er
Er
Er
Dx
cF
SJ
SJ
Gb
SJ
SJ
oD
Nm
BT
"}
(17,1,1) = {"
Jv
Qv
BT
Zf
Zf
Zf
Zf
BT
Pi
vP
vP
vP
vP
vP
vP
vP
vP
qk
Er
Er
Er
Er
Er
Er
Er
Er
Er
Er
Er
Dx
cF
SJ
SJ
Fp
SJ
SJ
oD
Nm
BT
"}
(18,1,1) = {"
Jv
Qv
BT
BT
BT
BT
BT
BT
Pi
vP
vP
vP
vP
vP
vP
vP
vP
ws
Er
Er
Er
gb
gb
gb
cE
gb
gb
Er
Er
FF
Fr
FF
FF
Hy
Hy
Hy
zf
Nm
BT
"}
(19,1,1) = {"
Jv
Qv
BT
Zf
Zf
Zf
Zf
BT
YZ
vP
vP
vP
vP
vP
vP
vP
vP
ws
Er
Er
Er
gb
EY
cE
EY
EY
gb
Er
Zm
FF
tB
Nk
mg
GV
GV
GV
Cf
Nm
BT
"}
(20,1,1) = {"
Jv
BT
BT
BT
BT
BT
BT
BT
zc
xk
xk
xk
xk
xk
xk
xk
xk
xk
xk
Er
Er
gb
gb
gb
EY
EY
gb
Er
Er
NC
pf
dP
FF
yJ
Gu
yJ
yJ
yJ
BT
"}
(21,1,1) = {"
Jv
kH
kH
FK
FK
FK
FF
FF
zc
yG
yG
yG
xk
yG
xk
yG
yG
yG
xk
Er
Er
gb
EY
cE
EY
EY
gb
Er
gB
FF
Os
zT
mg
wQ
Tv
Tv
dv
BT
BT
"}
(22,1,1) = {"
kH
kH
BY
FK
BY
PB
Er
Er
xk
xk
bQ
xk
xk
yG
xk
xk
bQ
xk
xk
Er
Er
gb
gb
gb
EY
EY
gb
Er
Er
FF
FF
FF
FF
mY
Tv
Tv
yJ
BT
BT
"}
(23,1,1) = {"
kH
BY
BY
PT
BY
PB
Er
Er
xk
yG
yG
yG
yG
yG
yG
yG
yG
yG
xk
Er
Er
gb
EY
cE
EY
EY
gb
Er
Er
zp
Er
Er
FF
zt
Tv
Tv
dv
BT
BT
"}
(24,1,1) = {"
kH
BY
BY
PB
PB
PB
Er
Er
xk
xk
bQ
xk
xk
yG
xk
xk
bQ
xk
xk
Er
Er
gb
gb
gb
cE
gb
gb
Er
Er
Er
Er
Er
FF
ix
iI
ix
ix
ix
BT
"}
(25,1,1) = {"
kH
BY
BY
BY
BY
PB
zp
Er
xk
yG
yG
yG
xk
yG
xk
yG
yG
yG
xk
Er
Er
Er
Er
Er
Er
Er
Er
Er
Er
zp
Er
Er
re
Er
Er
Er
mX
FF
BT
"}
(26,1,1) = {"
kH
BY
BY
BY
BY
PB
Er
Er
xk
xk
xk
xk
xk
bQ
xk
xk
xk
xk
xk
Er
Er
Er
Er
Er
Er
Er
Er
Er
Er
zp
re
re
zp
Er
VE
Jg
UM
FF
BT
"}
(27,1,1) = {"
kH
BY
BY
BY
BY
de
Er
Er
Er
Er
Er
Er
Er
Er
Er
Er
Er
Er
Er
Er
Er
Er
Er
Er
Er
Er
Er
Er
Er
Er
Er
Er
Kx
Er
Jg
me
et
FF
BT
"}
(28,1,1) = {"
kH
BY
BY
BY
BY
PB
Er
Er
Er
Er
Er
Er
Er
Er
Er
Er
Er
Er
Er
Er
Er
Er
Er
Er
Er
Er
Er
Er
Er
Er
Er
Er
zp
GL
uG
bd
Uy
FF
BT
"}
(29,1,1) = {"
PB
PB
BY
BY
FK
FK
FF
Dx
kv
iR
Ug
iR
rN
Do
Do
Do
dt
yC
yC
yC
yC
wM
Er
wM
wM
zp
wM
Er
wM
zp
zp
zp
zp
zp
zp
zp
FF
FF
BT
"}
(30,1,1) = {"
Jv
PB
BY
BY
FK
Tt
BT
BT
kv
uw
uw
uw
rN
cl
cl
cl
cl
yC
cl
cl
yC
Er
Er
Er
Er
zp
Er
Er
Er
Er
Er
Er
Er
Er
Er
Er
FF
BT
BT
"}
(31,1,1) = {"
qw
qw
qw
gp
qw
qw
NA
BT
eo
uw
uw
uw
rN
cl
cl
cl
cl
yC
cl
cl
yC
Er
Er
Er
Er
zp
Er
Er
Er
Er
Er
Er
Er
Er
Er
Er
FF
BT
Jv
"}
(32,1,1) = {"
qw
dX
dX
dX
dX
qw
BT
BT
eo
uw
uw
uw
rN
cl
cl
cl
cl
yC
cl
cl
yC
Er
Er
Er
Er
zp
Er
Er
Er
Er
Er
Er
Er
Er
Er
Er
Dx
BT
ho
"}
(33,1,1) = {"
qw
dX
dX
dX
dX
qw
BT
BT
kv
uw
uw
uw
rN
cl
cl
cl
cl
yC
cl
yC
yC
Er
Er
Er
Er
zp
Er
Er
Er
Er
Er
Er
Er
Er
Er
Er
Dx
BT
ho
"}
(34,1,1) = {"
qw
dX
dX
dX
dX
qw
BT
BT
JF
RS
xg
RS
RS
cl
cl
cl
cl
cl
cl
cl
yC
Er
Er
Er
Er
zp
Er
Er
Er
Er
Er
Er
Er
Er
Er
Er
FF
BT
ho
"}
(35,1,1) = {"
qw
qw
qw
qw
qw
qw
BT
BT
JF
iw
iw
iw
RS
cl
cl
cl
cl
cl
cl
cl
jd
FF
Dx
Dx
FF
FF
Er
Er
Er
Er
Er
Er
Er
Er
Er
Er
FF
BT
ho
"}
(36,1,1) = {"
Jv
Jv
Jv
Jv
Jv
ho
BT
BT
dJ
iw
iw
iw
RS
cl
cl
cl
cl
cl
cl
cl
jd
BT
BT
BT
BT
FF
FF
Er
Er
Er
Er
Er
Er
Er
Er
Er
FF
BT
ho
"}
(37,1,1) = {"
Jv
Jv
Jv
Jv
Jv
ho
BT
BT
JF
iw
iw
JF
JF
jd
It
It
It
jd
It
jd
jd
BT
Jv
Jv
BT
BT
FF
Dx
Dx
Dx
FF
FF
Dx
Dx
Dx
FF
FF
BT
ho
"}
(38,1,1) = {"
Jv
Jv
Jv
Jv
Jv
ho
BT
BT
JF
JF
JF
JF
BT
BT
BT
BT
BT
BT
BT
BT
BT
BT
Jv
Jv
Jv
BT
BT
BT
BT
BT
BT
BT
BT
BT
BT
BT
BT
BT
ho
"}
(39,1,1) = {"
Jv
Jv
Jv
Jv
Jv
ho
BT
BT
BT
BT
BT
BT
BT
Jv
Jv
Jv
Jv
Jv
Jv
Jv
Jv
Jv
Jv
Jv
Jv
Jv
Jv
Jv
Jv
Jv
Jv
Jv
Jv
Jv
Jv
Jv
Jv
Jv
ho
"}
(40,1,1) = {"
Jv
Jv
Jv
Jv
Jv
ho
ho
ho
ho
ho
ho
ho
ho
ho
ho
ho
ho
ho
ho
ho
ho
ho
ho
ho
ho
ho
ho
ho
ho
ho
ho
ho
ho
ho
ho
ho
ho
ho
ho
"}
